    EVAN'S ADVENTURE: MAP    
=============================
     _       _ _             
[H] | |  _ _|   |    _   _   
|   | | |  _  | |_ _| |_| |_ 
|   | |_| |_ _|_ _ _   _ _ _|
|   |_ _ _ _    |  _| |_ _  |
|   |_ _   _ _| |_   _|_   _|
|   |_    |  _ _|  _ _ _|   |
|     | |_| |  _ _   _ _| |_ 
[A]   |_ _  |_ _ _|_ _ _ _ _|
         START               
    [1]------------------[12]

=============================